1 5 3394 3393 674 3120 3106 
1 5 3106 3100 3070 3053 3042 
1 5 3042 3030 2896 2971 2961 
1 5 2889 2879 2705 2850 2830 
1 5 2199 2172 3616 2097 2087 
1 7 2087 2072 3603 3594 3584 1922 1915 
1 5 1802 1781 3540 1704 1696 
1 5 916 3352 3773 3338 3333 
1 5 3333 3329 3770 3315 3311 
1 5 3311 3304 3760 1664 3286 
1 5 3286 3284 3758 3260 3256 
1 5 3256 3252 3754 3235 3220 
1 5 3220 3206 3750 3195 3189 
1 5 3189 3170 3745 3134 3127 
1 5 3127 3107 3738 3059 3051 
1 5 3051 3041 3734 2994 2977 
1 9 2977 2960 3729 3726 3721 3718 3716 2794 2784 
1 5 2784 2790 2921 2791 2785 
1 8 2784 2768 3700 3697 3687 3682 2592 2582 
1 5 2582 2577 2569 2545 2512 
1 5 2582 2575 2568 2542 2511 
1 5 3152 3137 3739 3091 3080 
1 6 3673 3666 3663 3657 2340 2322 
1 5 2198 2179 3615 2096 2087 
1 5 2199 2241 3641 2314 2322 
1 5 2322 2308 3640 2240 2198 
1 5 2200 2243 3643 2309 2318 
1 5 2318 2333 3655 2383 2397 
1 5 2513 2500 3669 2451 2443 
1 5 2201 2230 270 2177 2202 
1 5 2508 2537 160 2573 2584 
1 5 2202 2177 3620 2108 2090 
1 5 2090 2107 3619 2164 2201 
1 5 3389 2606 3683 2639 3390 
1 5 3390 2663 3694 2695 2708 
1 5 2708 2719 3708 2750 2766 
1 5 2766 2781 3715 2805 2827 
1 5 2827 2844 1791 2900 2918 
1 5 2918 2926 550 2974 3000 
1 5 3000 3012 3245 3075 3097 
1 5 3097 3104 513 3156 3178 
1 6 2582 2591 447 315 2691 2706 
1 6 2706 2714 3706 3713 2807 2828 
1 5 2828 2846 3719 2877 2887 
1 5 2950 2957 3733 3002 3027 
1 5 3027 3036 3737 3066 3084 
1 5 3240 3243 3756 3267 3276 
1 5 2928 2933 3731 2963 2976 
1 3 3740 3146 3164 
1 5 3265 3273 3759 3287 3294 
1 5 3294 3300 3766 3306 3314 
1 6 2785 2774 3707 3698 2679 2666 
1 5 2666 2672 3696 2698 2693 
1 5 2623 2628 3692 2674 2693 
1 5 2853 2863 3722 2913 2928 
1 5 2372 2390 3662 2437 2458 
1 5 2372 2381 3660 2380 2371 
1 5 1924 1917 3575 1865 1856 
1 5 1874 1888 215 1925 1953 
1 6 1874 1887 202 137 2000 3378 
1 5 3378 2011 209 1957 1953 
1 6 2198 2179 3627 3821 3628 2172 
1 7 2322 2301 3632 3821 3621 2105 2087 
1 3 2582 2572 3673 
1 7 2511 2497 856 3835 859 2529 2512 
1 5 2510 2489 3674 2495 2509 
1 10 2623 2605 3837 3834 3832 3830 3828 3825 2245 2201 
1 5 1693 1702 3805 1749 1801 
1 5 1693 1690 3536 3371 3373 
1 4 1801 1811 3541 3536 
1 10 3373 3375 3542 3543 3544 3545 3546 3547 1722 1744 
1 5 1826 1834 3565 1860 1876 
1 5 1876 1851 3562 1774 1744 
1 5 3565 1825 1806 1773 1744 
1 5 3364 3368 3530 1712 1745 
1 7 1745 1766 3550 3808 3551 1852 1870 
1 5 1870 1884 3577 1931 1954 
1 5 1954 1963 3593 2017 2030 
1 5 2030 2044 3609 3379 3383 
1 5 3383 3385 3617 2100 2124 
1 5 1745 1775 3563 1869 1899 
1 5 1504 1491 3490 1459 1442 
1 17 1442 1429 3487 1453 1443 1430 3486 1426 1444 1431 3488 1457 1445 1422 3484 1401 1392 
1 5 915 927 3422 905 3357 
1 6 915 904 3421 3420 906 914 
1 5 914 931 3425 956 963 
1 5 963 970 3429 999 1007 
1 5 1007 1015 3434 1045 1052 
1 5 1052 1060 3441 1101 1128 
1 5 1128 1156 3456 1191 1207 
1 3 1207 1211 3465 
1 3 3465 1294 1312 
1 5 1312 1322 3475 1342 1355 
1 5 1522 1525 3496 1554 1577 
1 7 1577 1592 3503 3512 3521 1683 1693 
1 5 1552 1531 3019 1500 1489 
1 5 1489 1472 3473 1395 1384 
1 5 1384 1359 3797 1306 1296 
1 5 1296 1279 3467 1252 1241 
1 5 1241 1223 3464 1201 1189 
1 5 1189 1178 3455 1148 1124 
1 5 1124 1136 3448 1107 1125 
1 5 1125 1138 3449 1139 1126 
1 5 1126 1140 3450 1109 1127 
1 5 1127 1142 3451 1110 1128 
1 5 1124 1092 3442 1074 1067 
1 5 1067 1054 3435 1036 1028 
1 5 1028 1011 3432 996 986 
1 5 986 973 3428 952 942 
1 5 942 921 3419 892 885 
1 5 885 878 3417 872 867 
1 5 867 862 3415 855 845 
1 6 845 850 3413 3412 840 844 
1 6 844 847 3414 3416 881 884 
1 5 884 888 3418 918 941 
1 5 941 946 3427 969 983 
1 5 983 991 3430 1010 1027 
1 5 1027 1034 3436 1066 1081 
1 5 1081 1084 3446 1105 1134 
1 5 1134 1162 3454 1173 1185 
1 5 1185 1193 3462 1216 1229 
1 5 1229 1239 3466 1266 1272 
1 5 1272 1278 3470 1299 1320 
1 5 1320 1331 3474 1349 1370 
1 5 1370 1383 3482 1407 1428 
1 6 1428 1441 3489 3493 1542 1566 
1 5 1566 1581 1598 1610 1621 
1 9 1621 1631 3517 3522 3804 3527 3534 1771 1801 
1 7 2087 2063 3596 3572 3564 1803 1785 
1 5 1999 2008 187 2034 2056 
1 5 2056 2067 3612 2114 2151 
1 5 2151 2168 3626 2250 2288 
1 5 2288 2302 3648 2354 2374 
1 5 2744 2753 2570 2813 2835 
1 6 2835 2855 2868 253 2993 3017 
1 5 2374 2353 376 2283 2263 
1 5 2263 2194 437 2071 2058 
1 5 3578 3595 3608 2095 2112 
1 4 3518 3801 3799 3790 
1 5 3790 3788 3791 3792 3885 
1 4 1876 1895 3911 3578 
1 7 3518 3869 3531 3538 3552 1829 1856 
1 8 2513 2493 3996 3668 3665 3988 2407 2397 
1 9 2513 2547 3680 3681 3684 3838 3691 2682 2693 
1 5 2785 2797 3717 3724 3730 
1 9 2512 2499 3526 4009 3519 4010 3507 4011 2493 
1 8 2512 2499 3995 3667 3664 3987 2406 2397 
1 7 2397 2378 3980 3649 3642 2242 2199 
1 6 2321 2329 180 167 2328 2320 
1 9 2320 2306 192 3955 173 3945 140 2027 3378 
1 9 3378 2026 3606 3613 3625 3647 3651 2349 2372 
1 7 3400 3398 3571 3899 3559 1778 1747 
1 9 1747 1779 3560 3905 1935 1940 3919 2006 3378 
1 9 1856 1871 3574 3915 3585 3923 3597 2039 2058 
1 6 2374 2396 3983 3326 2457 2469 
1 6 2469 2475 4005 74 2596 2612 
1 6 3017 3029 4052 561 3126 3135 
1 6 3135 3141 4055 249 3202 3217 
1 6 2509 2538 4018 3679 2581 3389 
1 6 2887 2894 4048 3727 2935 2950 
1 6 3084 3099 4070 3741 3158 3179 
1 6 3179 3188 4058 3748 3396 3240 
1 8 1801 1817 3566 3580 3590 3604 2088 2111 
1 6 2111 2121 3948 3614 2089 2112 
1 8 1801 1817 3903 3569 3586 3925 3605 3941 
1 7 2090 2078 3601 3815 3582 1911 1899 
1 9 1355 1365 3480 3844 3485 3491 3847 1516 1522 
1 10 2510 2524 4007 3675 3676 3677 3678 4008 2527 2511 
1 6 2889 2904 4299 3082 2949 2961 
1 6 3394 3165 576 4339 3210 3226 
1 6 2763 2776 4283 3714 2817 2830 
1 6 2693 2703 3702 4278 2751 2763 
1 7 2693 2703 3705 4041 3712 2824 2853 
1 6 2976 2990 3736 4331 3063 3081 
1 3 3081 3093 3740 
1 5 3164 3176 3746 4310 3204 
1 3 3219 3232 4192 
1 3 3265 3258 3753 
1 7 2197 2212 3962 178 3963 2171 2198 
1 5 2321 2330 4244 154 2308 
1 9 2197 2170 211 3939 150 3929 204 1961 1953 
1 4 1874 1853 3793 3895 
1 7 2612 2619 317 4269 58 2729 2744 
1 6 1244 1257 4105 3468 1292 1305 
1 6 1305 1316 4109 3472 1353 1369 
1 3 1369 1381 3481 
1 4 3481 4120 1446 1467 
1 6 1562 1573 3501 4128 1635 1642 
1 6 1642 1651 3520 4148 1691 1696 
1 6 1802 1823 3567 4183 1902 1915 
1 7 2202 2248 4230 4239 751 2359 2373 
1 6 2373 2394 4251 427 2425 2431 
1 6 2431 2441 4257 744 2487 2508 
1 6 2646 2658 4 4275 2718 2737 
1 6 2737 2743 456 4286 2803 2826 
1 6 3364 3363 3864 1513 1582 1568 
1 5 3364 3360 3510 1613 1607 
1 6 1607 1590 3850 3494 1498 1488 
1 5 1488 1468 3483 1389 1372 
1 5 1372 1352 3476 1336 1332 
1 5 1332 1314 3471 1289 1281 
1 5 1281 1271 3469 1248 1240 
1 5 1240 1221 3463 1199 1186 
1 5 1186 1176 3457 1157 1129 
1 5 1129 1103 3443 1079 1069 
1 5 1069 1058 3437 1041 3358 
1 5 3358 1020 3431 987 981 
1 5 981 965 3426 933 915 
1 6 1552 1540 4385 4413 1561 1577 
1 6 1745 1765 4160 3548 1764 1744 
1 8 2828 2816 4408 4406 4405 4404 2539 2509 
1 9 2509 2476 4403 4402 4401 4400 4399 4398 2026 
1 7 1696 1706 4395 4396 4397 1925 1953 
1 10 1696 1687 4393 4392 4390 4412 4387 4384 1574 1566 
1 9 1826 1839 1859 3914 1923 2007 2069 2164 2201 
1 7 2830 2849 2864 4045 2893 2922 2928 
1 11 2928 2932 2944 2962 2979 3007 3016 3011 2996 2987 2977 
1 5 1999 1982 3592 3402 3400 
1 12 1924 1939 3842 3587 3602 3817 3818 3611 3954 3644 2347 2371 
1 9 1785 1735 3879 3533 3514 3499 3858 1563 1552 
1 9 2111 2127 3638 3827 3829 3831 3836 2605 2623 
1 9 2443 2433 3661 3654 3639 2261 2162 2129 2112 
1 6 1568 1547 4416 4415 1509 1504 
1 11 1826 1805 3554 1718 4394 4391 4389 4388 4386 1587 1577 
1 8 1552 1534 4414 4383 1528 1538 1556 1566 
1 8 2828 2847 4409 4410 4411 3966 2964 2977 
1 4 3080 3061 3735 3730 
1 13 2201 2246 3810 3539 3811 1719 1754 3807 4407 2223 3826 2821 2830 
1 6 3344 3337 4332 3771 3320 3314 
1 3 2584 2594 4265 
1 3 2646 2637 782 
1 6 1562 1548 4335 3495 3492 4126 
1 7 2199 2180 3629 3630 3631 2173 2200 
1 5 2318 2291 3623 4072 3941 
1 12 2200 2222 3964 2190 3820 3822 247 3967 216 3968 2176 2201 
